######################
#........##........#
#.####...##...####.#
#.#  #...##...#  #.#
#.#  #...##...#  #.#
#.####...##...####.#
#....................#
#.####.######.####.#
#....#...##...#....#
####.#...##...#.####
   #.#...##...#.#   
####.#...##...#.####
#....#...##...#....#
#.####.######.####.#
#....................#
#.####...##...####.#
#.#  #...##...#  #.#
#.#  #...##...#  #.#
#.####...##...####.#
#........##........#
######################
