####################
#                  #
#  ##        ##   #
#   #        #    #
#   #        #    #
#   #        #    #
#   ##########    #
#                 #
#                 #
#    ##########   #
#    #        #   #
#    #        #   #
#    #        #   #
#   ##        ##  #
#                 #
#                 #
#   #        #    #
#  ##        ##   #
#                 #
####################
