############################
#..........................#
#..........................#
#...##....................##
#...##.....................#
#..........................#
#..........................#
#..........................#
#..........................#
#..........................#
#..........................#
#..........................#
#..........................#
#..........................#
#..........................#
#..........................#
#.....................##...#
#.....................##...#
#..........................#
############################
